####################
<            #     #
<   ######   # #   #
< $ $  $ $ $       #
<   ######   # #   #
<            #     #
####################