#######################################
# Î GGGGGGGGGGGGGGGGGGGGGGGGGGGGGGGGGG>
# ñ GGGGGGGGMMGSGMMGMGSGMGMGGMGGMMGGMG>
# ò GGGGGGGGMGMGMGMGMGGMMGM$GMGMGSMGMG>
# î GGGGGGGGMGGMGGMGMGMGMGMMMMGMMMMGMG>
# ð GGGGGGGGMGG$GGMGMMGGMGMGGMGMGGMG$G>
# î GGGGGGGGMGGGGGMGMGSGMGMGSMGMSGMGMG>
# æ GGGGGGGGGGGGGGGGGGGGGGGGGGGGGGGGGG>
# í GGGGGGGGGGGGGGGGGGGGGGGGGGGGGGGGGG>
# î GGGGGGGGGGGGGGGGGGGGGGGGGGGGGGGGGG>
#   GGGGGGGGMMGSGMMGMGSGMGMGGMGGMMGGMG>
# ì GGGGGGGGMGMGMGMGMGGMMGM$GMGMGSMGMG>
# è GGGGGGGGMGGMGGMGMGMGMGMMMMGMMMMGMG>
# í GGGGGGGGMGG$GGMGMMGGMGMGGMGMGGMGSG>
# û GGGGGGGGMGGGGGMGMGSGMGMGSMGMSGMGMG>
<   GGGGGGGGGGGGGGGGGGGGGGGGGGGGGGGGGG>
<   GGGGGGGGGGGGGGGGGGGGGGGGGGGGGGGGGG>
#######################################