####################
< $           #    >
<   #   $   # #    >
< #   ###   #  $   >
<   #   $   # #    >
< $         #      >
####################