#######################################
#                                     #
#                                     #
#                                     #
#                                     #
#                                     #
#                                     #
#                                     #
<                                     >
<      $    $    $    $   $           >
#                                     #
#                                     #
#                                     #
#                                     #
#                                     #
#                                     #
#                                     #
#######################################