#######################################
#                                     #
#                                     #
#                                     #
#                                     #
#                                     #
#                                     #
#                                     #
<                                     #
<         $   $   $  $  $             #
#                                     #
#                                     #
#                                     #
#                                     #
#                                     #
#                                     #
#                                     #
#######################################