####################
#     $      #     >
#   ######   # #   >
# $ #    # $   #$  >
#   ######   # #   >
#     $      #     >
####################