####################
<            #     >
<   ######   # #   >
< $ $SS$   S$ $S   >
<   ######   # #   >
<            #     >
####################